1111555511
1        3
5   111111
5        3
5        3
5  1111  1
5  1  3  1
5  1  3  4
1        1
1333333431