1111555511
1 1      3
5 1      3
5 111    3
5   4    3
5  11  331
5  1     1
5  1     4
1        1
1333333431
