1121111111
1 2      1
1 2      3
1 222    1
1        1
5  2  2222
1  2  2  1
2222  2  1
1        1
1111141111
