1111111111
1 1      1
5 1      3
5 111    1
5        1
5  1  1111
1  1  1  1
1111  1  1
1        1
1111141111
