1111555511
1 1      3
5 1      3
5 111    3
5        3
5  1  1111
1  1  1  1
1111  1  4
1        1
1333333431
